15 20
0 S 0 0 0 0 0 0 0 0 0 0 0 0 0 0 0 0 0 0
0 1 0 0 0 0 0 0 0 0 0 0 0 0 1 1 1 1 1 T
0 1 1 1 1 1 0 0 0 1 1 1 0 0 1 0 0 0 0 0
0 0 0 0 0 1 0 0 0 1 0 1 0 0 1 1 1 1 1 0
0 0 0 0 0 1 0 0 0 1 0 1 0 0 0 0 0 0 1 0
S 1 1 1 1 1 1 1 0 1 0 1 1 1 0 0 0 0 1 0
0 0 0 0 0 1 0 1 0 1 0 0 0 1 0 0 0 0 1 0
0 0 1 1 1 1 0 1 0 1 0 0 0 1 0 0 0 0 1 0
0 0 1 0 0 0 0 1 0 1 0 0 0 1 0 0 0 0 1 0
0 0 1 0 0 0 0 1 0 1 0 0 0 1 0 0 0 0 1 0
0 0 1 0 0 0 0 1 0 1 0 0 0 1 0 0 0 0 1 0
0 0 1 0 0 0 0 1 0 1 0 0 0 1 0 0 0 0 1 0
0 0 1 1 1 1 1 1 1 1 0 1 1 1 0 0 0 0 1 0
0 0 0 0 0 0 0 1 0 0 0 1 0 0 0 0 0 0 1 0
0 0 0 0 0 0 0 T 0 0 0 1 1 1 1 1 1 1 1 0
